AU	ftp.au.debian.org;
AT	ftp.at.debian.org;
BY	ftp.by.debian.org;
BE	ftp.be.debian.org;
BA	ftp.ba.debian.org;
BR	ftp.br.debian.org;
BG	ftp.bg.debian.org;
CA	ftp.ca.debian.org;
CL	ftp.cl.debian.org;
CN	ftp.cn.debian.org;
HR	ftp.hr.debian.org;
CZ	ftp.cz.debian.org;
DK	ftp.dk.debian.org;
SV	ftp.sv.debian.org;
EE	ftp.ee.debian.org;
FI	ftp.fi.debian.org;
FR	ftp.fr.debian.org;
DE	ftp.de.debian.org;
GR	ftp.gr.debian.org;
HK	ftp.hk.debian.org;
HU	ftp.hu.debian.org;
IS	ftp.is.debian.org;
IR	ftp.ir.debian.org;
IE	ftp.ie.debian.org;
IT	ftp.it.debian.org;
JP	ftp.jp.debian.org;
KR	ftp.kr.debian.org;
LT	ftp.lt.debian.org;
MX	ftp.mx.debian.org;
NL	ftp.nl.debian.org;
NC	ftp.nc.debian.org;
NZ	ftp.nz.debian.org;
NO	ftp.no.debian.org;
PL	ftp.pl.debian.org;
PT	ftp.pt.debian.org;
RO	ftp.ro.debian.org;
RU	ftp.ru.debian.org;
SK	ftp.sk.debian.org;
SI	ftp.si.debian.org;
ES	ftp.es.debian.org;
SE	ftp.se.debian.org;
CH	ftp.ch.debian.org;
TW	ftp.tw.debian.org;
TH	ftp.th.debian.org;
TR	ftp.tr.debian.org;
UA	ftp.ua.debian.org;
US	ftp.us.debian.org;