# Updated on 2014-12-20 03:00
AL	al.archive.ubuntu.com;
AR	ar.archive.ubuntu.com;
AU	au.archive.ubuntu.com;
AT	at.archive.ubuntu.com;
BY	by.archive.ubuntu.com;
BO	bo.archive.ubuntu.com;
BA	ba.archive.ubuntu.com;
BW	bw.archive.ubuntu.com;
BR	br.archive.ubuntu.com;
BG	bg.archive.ubuntu.com;
BI	bi.archive.ubuntu.com;
CL	cl.archive.ubuntu.com;
CN	cn.archive.ubuntu.com;
CO	co.archive.ubuntu.com;
CR	cr.archive.ubuntu.com;
HR	hr.archive.ubuntu.com;
CZ	cz.archive.ubuntu.com;
DK	dk.archive.ubuntu.com;
EC	ec.archive.ubuntu.com;
FK	fk.archive.ubuntu.com;
FI	fi.archive.ubuntu.com;
PF	pf.archive.ubuntu.com;
GE	ge.archive.ubuntu.com;
DE	de.archive.ubuntu.com;
GR	gr.archive.ubuntu.com;
GL	gl.archive.ubuntu.com;
GY	gy.archive.ubuntu.com;
HU	hu.archive.ubuntu.com;
IS	is.archive.ubuntu.com;
IR	ir.archive.ubuntu.com;
IE	ie.archive.ubuntu.com;
IL	il.archive.ubuntu.com;
IT	it.archive.ubuntu.com;
JP	jp.archive.ubuntu.com;
KE	ke.archive.ubuntu.com;
KR	kr.archive.ubuntu.com;
KW	kw.archive.ubuntu.com;
LV	lv.archive.ubuntu.com;
LS	ls.archive.ubuntu.com;
LI	li.archive.ubuntu.com;
LT	lt.archive.ubuntu.com;
LU	lu.archive.ubuntu.com;
MK	mk.archive.ubuntu.com;
MT	mt.archive.ubuntu.com;
MD	md.archive.ubuntu.com;
MN	mn.archive.ubuntu.com;
MZ	mz.archive.ubuntu.com;
NA	na.archive.ubuntu.com;
NP	np.archive.ubuntu.com;
NL	nl.archive.ubuntu.com;
NC	nc.archive.ubuntu.com;
NZ	nz.archive.ubuntu.com;
NO	no.archive.ubuntu.com;
PK	pk.archive.ubuntu.com;
PY	py.archive.ubuntu.com;
PE	pe.archive.ubuntu.com;
PH	ph.archive.ubuntu.com;
PL	pl.archive.ubuntu.com;
PT	pt.archive.ubuntu.com;
RO	ro.archive.ubuntu.com;
RU	ru.archive.ubuntu.com;
RW	rw.archive.ubuntu.com;
SM	sm.archive.ubuntu.com;
SG	sg.archive.ubuntu.com;
SI	si.archive.ubuntu.com;
SO	so.archive.ubuntu.com;
ZA	za.archive.ubuntu.com;
GS	gs.archive.ubuntu.com;
SR	sr.archive.ubuntu.com;
SZ	sz.archive.ubuntu.com;
SE	se.archive.ubuntu.com;
CH	ch.archive.ubuntu.com;
TW	tw.archive.ubuntu.com;
TZ	tz.archive.ubuntu.com;
TH	th.archive.ubuntu.com;
TR	tr.archive.ubuntu.com;
UG	ug.archive.ubuntu.com;
UA	ua.archive.ubuntu.com;
GB	gb.archive.ubuntu.com;
UY	uy.archive.ubuntu.com;
UZ	uz.archive.ubuntu.com;
VE	ve.archive.ubuntu.com;
ZM	zm.archive.ubuntu.com;
ZW	zw.archive.ubuntu.com;